0000000000
0000000000
0000000000
00000■0000
0000■00000
0000■■■000
0000000000
0000000000
0000000000
0000000000